11111111111111111111
1S000000111111111111
11111110111111111111
11111110111111111111
11100000000001111111
11101111111101111111
11101111111100011111
11100000111111111111
11111110111111111111
11111000000001111111
11111011111101111111
11110011111100111111
11110111111110111111
1111011111FF11111111
1111011111FF11111111
11110111111011111111
11110111111011111111
11110111111011111111
11110000000000001111
11111111111111111111